 26 26 25 25 25 25 25 25 25 25 25 25 26 26
 26 26 11  4  1  4  1  1  4  1  4  9 26 26
 26 26 11  5  7  5  1  1  1  1  5  9 26 26
 26 26 11  5  5  4  4  5  1  5  5  9 26 26
 26 26 11  1  1  5  5  5  1  1  1  9 26 26
 26 26 11  1  1  5  1  1  1  1  1  9 26 26
 26 26 11  2  2  2  2  2  2  2  2  9 26 26
 26 26 11  1  6  1  1  1  1  1  1  9 26 26
 26 26 11  1  5  5  1  1  5  5  1  9 26 26
 26 26 11  1  1  1  1  5  5  1  1  9 26 26
 26 26 11  1  1  1  1  1  5  1  1  9 26 26
 26 26 11  2  2  2  1  1  2  2  2  9 26 26
 26 26 11  1  5  5  1  1  1  1  1  9 26 26
 26 26 11  1  7  5  1  1  1  1  1  9 26 26
 26 26 11  1  1  1  1  1  1  1  1  9 26 26
 26 26 11  1  1  1  1  1  1  1  1  9 26 26
 26 26 11  1  1  1  5  5  1  1  1  9 26 26
 26 26 11  1  1  1  5  5  1  1  1  9 26 26
 26 26 11  1  1  1  5  1  1  1  1  9 26 26
 26 26 11  1  6  1  1  1  1  1  1  9 26 26
 26 26 11  1  1  1  1  1  1  1  1  9 26 26
 26 26 11  1  1  1  1  1  1  1  1  9 26 26
 26 26 11  1  1  1  1  1  1  1  1  9 26 26
 26 26 11  2  2  2  1  1  2  2  2  9 26 26
 26 26 11  2  2  2  1  1  2  2  2  9 26 26
 26 26 11  1  7  1  1  1  1  1  1  9 26 26
 26 26 11  1  5  5  5  1  1  1  1  9 26 26
 26 26 11  1  1  1  5  1  1  1  1  9 26 26
 26 26 11  1  1  1  1  1  1  1  1  9 26 26
 26 26 11  1  1  1  1  1  1  1  1  9 26 26
 26 26 11  1  1  1  1  1  1  1  1  9 26 26
 26 26 11  1  7  1  1  1  1  1  1  9 26 26
 26 26 11  2  2  2  2  2  2  2  2  9 26 26
 26 26 11  1  1  1  1  1  1  1  1  9 26 26
 26 26 11  1  1  1  1  1  1  1  1  9 26 26
 26 26 11  1  1  1  1  1  1  1  1  9 26 26
 26 26 11  1  1  1  1  1  1  1  1  9 26 26
 26 26 11  1  6  1  1  1  1  1  1  9 26 26
 26 26 11  1  1  1  1  1  1  1  1  9 26 26
 26 26 21 10 10 14  1  1  1  1  1  9 26 26
 26 26 26 26 26 11  1  1  1  1  1  9 26 26
 26 26 26 26 26 11  1  1  1  1  1  9 26 26
 26 26 18  8  8 15  1  1  1  1  1  9 26 26
 26 26 11  1  7  1  1  1  1  1  1  9 26 26
 26 26 11  1  1  1  1  1  1  1  1  9 26 26
 26 26 11  1  1  1  1  4  4  1  1  9 26 26
 26 26 11  1  1  1  1  1  1  1  1  9 26 26
 26 26 11  1  1  1  1  1  1  1  1  9 26 26
 26 26 11  1  5  7  5  1  1  1 13 20 26 26
 26 26 11  1  5  5  5  1  1  1 	9 26 26 26
 26 26 11  2  2  2  2  2  2  2 12 19 26 26
 26 26 11  1  1  1  1  1  1  1  1  9 26 26
 26 26 11  1  1  1  1  1  4  4  1  9 26 26
 26 26 11  1  1  1  1  1  1  1  1  9 26 26
 26 26 11  1  1  5  5  5  1  1  1  9 26 26
 26 26 11  1  1  1  6  1  1  1  1  9 26 26
 26 26 11  1  1  1  1  1  1  1  1  9 26 26
 26 26 11  1  2  2  2  2  2  2  1  9 26 26
 26 26 11  1  4  4  1  1  1  1  1  9 26 26
 26 26 11  1  1  1  1  1  5  1  1  9 26 26
 26 26 11  1  1  1  1  5  5  1  1  9 26 26
 26 26 11  1  1  1  6  7  1  1  1  9 26 26
 26 26 11  1  1  1  1  1  1  1  1  9 26 26
 26 26 21 10 10 10 10 10 10 10 10 20 26 26